0000000000000666666666666666666666666666666666666666666666666666666666666666666666668666666666666666
0000000000000666666666666666666666666666666666666666666666666666666666666666666666666666666666666666
0000000020000666666666666666666666666666666666666666666666666666666666666666666666666866666666666666
0000000000000666666666666666666666666666666666666666666666666666666666666666666666666666666666666666
0000000000000666666666666666666666666666666666666666666666666666666666666666666666666666666666666666
0000000000000666666666666666666666666666666666666666666666666686666666666666666666666666666666666666
0000000000000666666666666666666666666666666666666666666666666666666666666666666666666666666666666666
0000000000000666666666666666666666666666666666666666666666666666666766666666666666866666666666666666
0000000000000666666666666666666666666666666666666666666666666666666666666686666666666666666666666666
0000000000000666666666666666666666666666666666666666666666666666666666666666666666666666666666666666
0000000000000666666666666666666666666666666666666666666666666666666666666666666666666666666666666666
0000000000000666666666666666666666666666666666666666666666666666666666666666666666666666666666666666
0000000000000666666666666666666666666666666666666666666666666666666666666666666666666666666666666666
6666666666666000000000000066666666666666666666666666666666666666666666666666666666666666666666666666
6666666666666000000000000066666666666666666666666666666666666666666666666666666666666666666666666666
6666666666666000000000000066666666666666666666666666666666666666666666668666666666666666666666666666
6666666666666000000000000066676666666666666666666666666666666666666666666666666666666666666666666666
6666666666666000000000000066666666666666666666666666666666666666666666666666666666666666666666666666
6666666666666000000000000066666666666666666666666666666666666666666666666666666666666666666666666666
6666666666666000000000010066666666666666666666666666666666666666666666666666666666666666666666666666
6666666666666000000000000066666666666666666666666666666666666666666666666666666666666666666666666666
6666666666666000000000000066666666666666666666666666666666666666666686666666666666666666666666666666
6666666666666000000000000066666666666686666666666666666666666666666666666666666666666666666666666666
6666666666666000000000000266666666666666666666666666666666666666666666686666666666666666666666666666
6666666666666000000000000066666666666666666666666666666666667666666666666666666666666666666666666666
6666666666666000000000002166666666666666666666666666666666666666666666666666666666666666666666666666
6686666666666666666666666633333333333666666666666666666666666666666666666766666666666666666666666666
6666666666666666666666666633333333333666666666666666666666666766666666666666666666666666666666666666
6666666666666666666666666633333333333666666666666666666666666666666666666666666666676666666666666666
6666666666666666666666666633333333333666666666666666666666666666666666666666666666666666666666666666
6666666666666666666666666633333333333666666666666666666666666666666666666666666666666666666666666666
6666666666666666666666666633333333333666666666666666666666666666666666666666666666666666666666666666
6666666666666666666666666633333333333666666666666666666666666666666666666666666666666666666666666666
6666666666666666666666666633333333333666666666666666666666666666666666666666666666666666666666666666
6666666666666666666666666633333333333666666666666666666666666666666666666666666676666666666666666666
6666666666666666666666666633333333333666666666666666666666666666666666666666666666666666666666666666
6666666666666666666666666633333333333666666666666666666666666666666666666666666666666666666666666666
6666666666666666666666666666666666666333333333336666666666666666666666666666666666666666666666666666
6666666666666666666666666666666666666333333333336666666666666666666666666666666666666866666666666666
6666666666666666666666666666666666666333333333336666666666666666666666666666666666666666666666666666
6666666666666766666666666666666666666333333333336666666666666666666666666666666666666666666666666666
6666666666666666666666666666666666666333333333336666666666666666666666666666666666666666666666666666
6666666666666666666666666666666666666333333333336666668666666666666666666666666666666666666666666666
6666666666666666666666666666666666666333333333336666666666666666666666666666666666666666666666666666
6666666666666666666666666666666666666333333333336666666666666666666676666676666666666666666666666666
6666666666666666666666666666666666666333333333336666666666666666666666666666666666666666666666666666
6666666666666666666666666666666666666333333333336666666666666666666666666666666666666666666666666666
6666666666666666666666666666666666666333333333336666666666666666666666666666666666666666666666666666
6666666666666666666666666666666666666666666666663333333333366666666666666666666666666666666666666666
6666666666666666666666666666666666666666666666663333333333366666666666666666666666666666666666666666
6666666666666666666666666666666666666666666666663333333333366666666666666666666666666666666666666666
6666666666666666666666666666666666666666666666663333333333366666666666666666666666666666666666666666
6666666666666666666666666666666666666666666666663333333333366686666666666666666666666666666666666666
6666666666666666666666666666666666666666666666663333333333366666666666666666666666666666666666666666
6666666666666666666666666666666666666666666666663333333333366666666666666666666666666666666666666666
6666666666666666666666666666666666666666666666663333333333366666666666666666666666666666666666666666
6666666666666666666666666666666666666666666666663333333333366666666666666666666666666666666666666666
6666666866666666666666666666666666666666666666663333333333366666666666666666666666666666666666666666
6666666666666666666666666666666666666666666666663333333353366666666666666666666666666666666666666666
6666666666666666686666666666666666666666666666666666666666633333333333666666666666666666666666666666
6666666666666666666666666666666666666666666666666666666666633333333333666666666666666666666666666666
6666666666666666666666666666666666666666666666666666666666633333333333666666666666666666666666666666
6666666666666666666666666666666666666666666666666666666666633333333333666666666666666666666666666666
6666666666666666666666666666666766666666666666666666666666633333333333666666666666666666666666666666
6666666666666666666666666666666666666666666666666666666666633333333333666666666666666666666666666666
6666666666666666666666666666666666666666666666666666666666633333333333666666666666666666666666666666
6666666666666666686666666666666666666666666666666666666666633333333333666666666666666666666666666666
6666666666666666666666666666666666666666666666666666666666633333333333666666666666686666666666666666
6666666666666666666666666666666666666666666666666666666666633333333333666666666666666666666666666666
6666666666666666666666666666666666666666666666666666666666633333333354666666666666666666666666666666
6666666666666866666666666666666666666666666686666666666666666666666666666666666666666666666666666666
6666666666666666666666666666666666666666666666666666666666666666666666666666666666666866666666866666
6666666666666666666666666666666666666666666666666666666666666666666666666666666666666666666666666666
6666666666666666666666666666666666666666666666666666666666666666666666666666666668666666666666666666
6666666666666666666666666666666666666666666666666666666666666666666666666666666666666666666666666666
6666666666666666666666666666666666666666666666666666666666666666666666666666666666676666666666666666
6666666666666666666666666666666666666666666666666666666666666666666666666666666666666666666666666666
6666666666666666666666666666666666666666666666666666666666666666666666666666666666666666666666666666
6666666666666666666666666666666666666666666666666666666666666666666666666666666666666666666666666666
6666666666666666666666666666666666666666666666666666666666666666666666666666666666666666666666666666
6666666667666666666666666666666666666666666666666666666666666666666666666666666666666666666666666666
6666666666666666666666666666666666666666666666666666666666666666666666666666666666666666666666666666
6666666666666666666666666666666666666666666666666666666666666666666666666666666666666666666666666666
6666666666666666666666666666666666666666666666666666666666666666667666666666666666666666666666666666
6666666666666666666666666666666666666666666666666666666666666666666666666666666666666666666666666666
6666666666666666666666666666666666666666666666666666666666666666666666666666666666666666666666666666
6666666666666666666666666666666666666666666666666666666666767666666666666666666666666666666666666666
6666668666666666666666666666666666666666666666666666666666666666666666666666666666666666666666666866
6666666666666666666666666666666666666666666666666666666666666666666666666666666666666666666666666666
6666666666666666666666666666666666666666666666666666666666666666666666666666666666666666666666666666
6666666666666666666666666666666666666666666666666666666666666666666666766666666666666666666666666666
6666666666666666666666666666666666666666666666666666666666666666666666666666666666666666666666666666
6666666666666666666666666666666666666666666666666666666666666666666666666666666666666666666666666666
6666666666666666666666666666666666666666666666666666666666666666666666666666666666666686666666666666
7666766666666666666666666666666666666666666666666666666666666666666666666666666666666666666666666666
6666666666666666666666666666666666666666666666666666666666666666666666666666666666666666666666666666
6666666666666666666666666666666666666666666666666666666666666666666666666666666666666666666666666666
6666666666666666666666666666666666666666666666666666666666666666666668666666666666666666666666666666
6666666666666666666666666666666666666666666666666666666666666666666666666666666666666666666666666676
6666666666666666666666666666666666666666666666666666666666666666666666666666666666666666666666666687
