0006666666666666666666666
0006666666666666666667666
0007666666686666666666666
6660006666676666666666666
6660006666666666666666666
6660216666666666666686666
6666663333333336666666666
6666663333333336666667666
6666663333334336666666666
6666663333333336666666666
6666663333333336666666666
6666663333333336766666666
6666663333333336666666666
6666663333333336666666666
6666663333333546666666666
6666666666666666666666666
6666666666666666666666666
6666666666666666666666666
6666666666666666666686666
6666666666668666666666666
6666666666666666686666666
6666666666666666666666666
6666666666666666666666666
6666666666666666666666666
6666666666766666666666687
