0006666666666666666666666666666666666666666666666666666666666666666666666666666666666666666666666666
0006666666666666666666666666666666666666666666666666666666666666666666666666666666666666666666666666
0006666666666666666666666666666666666666666666666666676666666666666666666666666666666666666666666666
6660006666676666666666666666666666666666666666666666666666666666666666666666666666666666666666666666
6660006666666666666666666666666666666666666666666666666666666666666666666666666666666666666666666666
6660006666666666666666666666666666666666666668666666666666666666666666666666666666666666666666666666
6866660006666666666666666666666666666666666666666666666666666666666666666666666666666666666666666666
6666660006666666666666666666666666666666666666666666666666666666666666666666666666666666666866666666
6666660006666666666666666666666666666666666666666666666666666666666666666666666666666666666666666666
6666666661006666666666666666666666666666666666666666666666666666666666666666666666666666666666666666
6666666660006666666666666666666666666666666666666666666666666666666666666666666666666666666666666666
6666666660006666666666666666666666666666666666666666666666666666666666666666666666666666666666666666
6666666666660006666666666666666666666666666666666666666666666666666666666666666666666666666666666666
6666666666660006666666666666666666666666666666666666666666666666666676666666666666666666666666666666
6666666666660006666666666666666666666666666666666666666666666666666666666666666666666666666666666666
6666666666666660000666666666666666666666666666666666666666666666666666666666666666666666666666666666
6666666666666660000666666666666666666666666666666666666666666666666666666666666666666666666666666666
6666666666666660000666666666666666666666666666666666666666666666666666666666666666666666666666666666
6666666666666660021666666666666666666666666666666666666666666666666666666666666666666666666666686666
6666666666666666666333333333333333333333333333333333333333333666666666666666666666666666666666666666
6666666666666666666333333333333333333333333333333333333333333666666666666666666666666666666666666666
6666666666666666666333333333333333333333333333333333333333333666666666666666666666666666766666666666
6666666666666666666333333333333333333333333333333333333333333666666666666666666666666666666666666666
6666666666666666666333333333333333333333333333333333333333333666666666666666666666666666666666666666
6666666666666666666333333333333333333333333333333333333333333666667666667666666666666666666666666666
6666666666666666666333333333333333333333333333333333333333333666666666666666666666666666666666666666
6666666666666666666333333333333333333333333333333333333333333666666666676666666666666666666666666666
6666666666666666666333333333333333333333333333333333333333333866666666666666666666666666666666666666
6666666666666666666333333333333333333333333333333333333333333666666666666666666666666666666666666666
6666666666666666666333333333333333333333333333333333333333333666666666766666687666666666666666666666
6666666666666666666333333333333333333333333333333333333333333666666666666666666666666666666666666666
6666666676666666666333333333333333333333333333333333333333333666666666666666666666666666666666666666
6666666666666666666333333333333333333333333333333333333333333666666666666666666666666666666666666666
6666666666666668666333333333333333333333333333333333333333333666666666666766666666666666666666666666
6666666666666666666333333333333333333333333333333333333333333666666666666666666666666666666666666666
6666666666666666666333333333333333333333333333333333333333333666666666666666666666666666667666666666
6666666666666666666333333333333333333333333333333333333333333666666666666666666666666666666766666666
6666666666666666666333333333333333333343333333333333333335333666666666666666666666666666666666666666
6666666666666666666333333333333333333333333333333333333333333666666666666666666666666666666666666666
6666666666666666666333333353333333333333333333333333333333333666666666666666666666666666666666666666
6666666666666666666333333333333333333333333333333333333333333666667666666666666666666666666666666666
6666666666686666666333333333333333333333333333333333333333333666666666666666666666666666666666666666
6666666666666666666333333333333333333333333333333333333333333666766666666666666666666666666666666666
6666666666666666666333333333333333333333333333333333333333333666666666666666666666666666666666666666
6666666666666666666333333333333333333333333333333333333333333666666666666666666666666666666666666666
6666666666666666666333333333333333333333333333333333333333333666666666666666666666666666666666666666
6666677666666666666333333333333333333333333333333333333333333666666666666666666666666666666666666666
6666666666666666666333333333333333333333333333333333333333333666666666666666666666666666666666666666
6666666666666666666333333333353333333333333333333333333333333666666666666666666666666666666666666666
6666666666666666666333333333333333333333333333333333333333333666666666666666666666666666666666666666
6666666666666666666333333333333333333333333333333353333333333666666666666666666666666666666666666666
6666666666666666666333333333333333333333333333333333333333333666666666666666666666666666666666666666
6666666666666666666333333333333333333333333333333333333333333666666666666666666666666666666666666666
6666666666666666666333333333333333333333333333333333333333333666666666666666666666686666666666666666
6666666666666666666333333333333333333333333333333333333333333666666666666666666666666666666666666666
6666666666666666666333333333333333333333333333333333333333333666666866666666666666666666666666666666
6666666666666666666333333333333333333333333333333333333333333666666666666666666666666666666666666666
6666666666666666666333333333333333333333333333333333333333333666666666666666666666666666666666666666
6666766666666666666333333333333333333333333333333333333333333676666666666666666666666666666666666666
6666666666666666666333353333333333333333333333333333333333333666666666666666666666666666666666666666
6666666666666666666333333333333333333333333333333333333333354666666666666666666666666666666666666666
6666666666666666666666666666666666666666666666666666666666666666666666666666666666666666666666666666
6666666666666666666666666666666666666666666666666666666668666666666666666666666666666666666666666666
6666666666666666666666666666666666666666666666666666666666666666666666666666666666666666666666666666
6666666666666666666666666666666666666666666666666666666666666666666666666666666666666666666666666666
6666666666666666666666666666666666666666666666666666666666666666666666666666666666666666666666666666
6666666666666666666666666666666666666666666666666666666666666666666666666666666666666666666666666666
6666666666666666666666666666666666666666666666666666666666666666666666666666666666666666666666666666
6666666666666666666666666666666666666666666666676666666666666666666666666666666666666666666666666666
6666666666668666666666666666666666666666666666666666666666666666666666666666666666666666666666666666
6666666666666666666666666666666666666666666666666666666666666666666666666666666666666666666666666666
6666666666666666666666666666666666666666666666666666666666666666666666666666666666666666666666666666
6666666666666666666666666666666666666666666666666666666666666666666666666666666666666666666666666666
6666666666666666666666666666666666666666666666666666666666666666666666666666666666666666666666666666
6666666666666666666666666666666766666666666666666666666666666666666666666666666666666666666666666666
6666666666666666666666666666666666666666666666666666666666666666666666666666666666666666666666666666
6666666666666666666666666666666666666666666666666666666666666666666666666666666666666666666666666666
6666668666666666666666666666666666666666666666666666666666666666666666666666666666666666666666666666
6666666666666666666666666666666666666666666666666666666666666666666666666666666666666666666666666666
6666666666666666666666666666666666666666666666666666666666666666666666666666666666666666666666666666
6666666666666666666666666666666666666666666666666666666666666666666666666666666666666666666666666666
6666666666666666666666666666666666666666666666666666666666666666666666666666666666666666666666666666
6666666666666666666667666666686666666666666666666666666666666666666666666666666666666666666666666666
6666666666666666666666666666666666666666666666666666666666666666666666666666666666666666666666666666
6666666666666666666666666666666666666666666666666666667666666666666666666666666666666666666666666666
6666666666666666666666666666666666666666666666666666666666666666666666666666666666666666666666666666
6666666666666666666668666666666666666666666666666666666666666666666666666666666666666666666666666666
6666666666666666666666666666666666666666666666666666666666666666666666666666666666666666666666666666
6666667666666666666666666666666666666666666666666666666666666666666666666666666666666666666666666666
6666666666666666666666666666666666666666666666666666666666666666666666666666666666666666666666666666
6666666666666666666666666666666666666666666666666666666666666766666666666666666666666666666666666666
6666666666666666666666666666666666666666666666666666666666666666666666666666666666666666666666666666
6666666666666666666666666666666666666666666666666666666666666666666666666666666666666666666666666666
6666666666666666666666666666666666666666666666666666666666666666666666666666666666666666666666666666
6666666666666666666666666666666666666666666666666666666666666666666666666666666666666666666666666666
6666666666666666666666666666666666666666668666666666666666666666666666666666666666666666666666666666
6666666666666666666666666666666666666666666666666666666666666666666666666666666666666666666666666666
6666666666667666666666666666666666666666666666666666666666666666666666666666666666666666666666666666
6666666666666666666666666666666666666666666666666666666666666666666666666666666666666666666666666666
6666666666666666666666666666666666676666666666666666666666666666666666666666666666666666666666666687
